WE  ../xpm/bricks.xpm
EA  ../xpm/oak_log.xpm
SO  ../xpm/cobblestone.xpm
NO  ../xpm/obsidian.xpm

F   70,70,70
C   150,150,230

   111    1
  1S111  101   1   11111
 1101111 101 111 1111111
1110011111011111111111111
1000000000010000000000001
1011000001110000100000001
100100000000000000000000111111111
111101111011000001110000000000001
100000000010000001110111111111111
1000011111 111011100000010001
1000011111111011101010010001
110000001101010111000010000011
1000000000000000000001 10000011
1000000010000000000100100000101
1110000111110101111101000000111
  110111 1 10101 101111010001
  111111 1 11111 11111111111
