WE  ./sprites/neonray.xpm
EA  ./sprites/neontunnelbright.xpm
SO  ./sprites/neontunneltriangle.xpm
NO  ./sprites/neontunnelsquare.xpm

F   70,70,70
C   150,150,230

  1111    1
  11111  101   1   11111
 1101111 101 111 1111111
1110011111011111111111111
1000000000010000000000001
1011000001010000100000001
100100000000000000000000111111111
1111010N0011000001110000000000001
11110100011111111111000001111111
10000110111111011100000010001
1000011011111011101010010001
110000001100010111000010000011
1000000000000000000001010000011
1000000010000000000100100000101
1110000111110101111101000000111
  110111 1 10101 101111010001
  111111 1 11111 11111111111
