WE  ./sprites/w_texture.xpm
EA  ./sprites/e_texture.xpm
SO  ./sprites/s_texture.xpm
NO  ./sprites/n_texture.xpm

C   255,255,255
F   0,0,0

     1111
    100001
    10101    1
    10001
     111 
