WE  ./sprites/w_texture.xpm
EA  ./sprites/e_texture.xpm
SO  ./sprites/s_texture.xpm
NO  ./sprites/n_texture.xpm

C   255,255,255
F   0,0,0

    11111
    101001
    11001   1
    10001
    11111
