EA ./path_to_the_east_texture
WE ./path_to_the_west_texture
SO ./path_to_the_south_texture
NO ./path_to_the_north_texture

C 225,30,0
F 220,100,0

    11111
    10001
    10101
    100N1
    11111
