WE  ../xpm/bricks.xpm
EA  ../xpm/neontunnelsquare.xpm
SO  ../xpm/neontunnelsquare.xpm
NO  ../xpm/neontunnelsquare.xpm

C   255,255,255
F   0,0,0

     1111
    101001
    11W11    1
    10101
     111 
